F 32,32,32
C 0,0,100

NO textures/puppystein_north.xpm
SO textures/puppystein_south.xpm
WE textures/puppystein_west.xpm
EA textures/puppystein_east.xpm
D textures/puppystein_statue.xpm

1111111111111111111
1001001001001001001
1001001000001001001
100100111D111001001
1001001000001001001
100000000N000000001
1000011111111000001
1111111111111111111