F 32,32,32
C 0,0,100

NO textures/puppystein_north.xpm
SO textures/puppystein_south.xpm
WE textures/puppystein_west.xpm
EA textures/puppystein_east.xpm
D0 textures/puppystein_door_0.xpm
D1 textures/puppystein_door_1.xpm
D2 textures/puppystein_door_2.xpm
D3 textures/puppystein_door_3.xpm

1111111111111111111
1001001000001001001
1001001000001001001
100100111D111001001
1001001000001001D11
100000000N000000001
1000011111111001001
1111111111111111111